9 10 10 10 10 10 10 10 10 10 10 10 10 10 10 11
12 13 18 13 13 18 13 13 19 13 13 13 13 13 13 14
12 13 13 13 13 13 13 13 13 13 13 13 13 19 13 14
12 13 13 19 13 13 13 13 13 13 18 13 13 13 13 14
12 13 18 13 13 13 13 13 13 13 13 18 13 13 13 14
12 13 13 13 13 13 13 13 0 1 1 1 1 2 13 14
12 19 13 13 13 18 13 13 3 4 4 4 4 5 13 14
12 13 13 13 18 13 13 13 3 4 4 4 4 5 13 14
12 13 13 13 13 13 13 13 6 7 7 7 7 8 13 14
12 13 18 13 13 13 13 18 13 13 13 19 13 13 13 14
12 13 13 13 13 13 13 13 13 18 13 13 13 18 13 14
15 16 16 16 16 16 16 16 16 16 16 16 16 16 16 17